############################
#............##............#
#.####.#####.##.#####.####.#
#.####.#####.##.#####.####.#
#.####.#####.##.#####.####.#
#..........................#
#.####.##.########.##.####.#
#.####.##.########.##.####.#
#......##....##....##......#
######.#####-##-#####.######
######.#####-##-#####.######
######.##----------##.######
######.##----------##.######
######.##-########-##.######
------.---########---.------
------.---########---.------
######.##-########-##.######
######.##-########-##.######
######.##----------##.######
######.##----------##.######
######.##-########-##.######
#............##............#
#.####.#####.##.#####.####.#
#.####.#####.##.#####.####.#
#...##.......--.......##...#
###.##.##.########.##.##.###
###.##.##.########.##.##.###
#......##....##....##......#
#.##########.##.##########.#
#.##########.##.##########.#
#..........................#
############################